XXXXXXXXXXXXXXXXXXXXXXXXXXXXXXXXXXXXXXXXXXXXX
X1111111c1111X11232112X12221X333111231312311X
X122312322221X31221231XX1d1XX332221123X33212X
X122321111111X231211123XXXXX1332221123X33212X
X122312322221X111111111X11111111111122X33212X
X12XXXXXXXXXXX111111111X11X11111111122X33212X
X1223133213333111112211X11X22123132313233212X
X1223232321X33212222233X33X3333X31a231X33212X
X1231123232X12112111X33333X3333X122321X33212X
X1111111111X11111111X33333X3333X112113X33212X
X11122222XXX2312223332111111111X113123111333X
X33322222X2123123313XXXXXXX12311223111112123X
X22111111X1232323211X3213123123X111221113111X
XXXXXXXXXXXX32111132131113111312311132212111X
X1111122222232331231XXXXXXXX1231312333112322X
X333123232XXXXXXXXXXXX1232232212123111112211X
X3333321111212121b12121212121212121212121212X
X12121212121212121212121212121XXXXXX11113111X
XXXXXXXXXXXXXXXXXXXXXXXXXXXXXXXXXXXXXXXXXXXXX
